SO textures/no_img.xpm
WE textures/no_img.xpm
EA textures/no_img.xpm
NO textures/no_img.xpm
F 220,100,255
C 225,30,250



1111
1N01
1111
