

SO textures/wood.xpm
NO textures/eagle.xpm
EA textures/purplestone.xpm
WE textures/bluestone.xpm

C 85,107,47
F 135,206,235






        1111111111111111111111111
        1000000001100000000000011
        10110000011100000000000011
        1001000000000000000000001
111111111011000001110000000000001
100000000011000001110111111111111
11110111111111011100000010001
11110111111111011101010010001
1100000000000101110011101000111
100000000E00000011001 100010001
1000000000000001101111110001111
1100000111010101111101111000111
11110111 1110101 101111010001
11111111 1111111 111111111111
