SO textures/no_img.xpm
WE textures/no_img.xpm
EA textures/no_img.xpm
NO textures/no_img.xpm
F 220,100,255
C 225,30,250


        1111111111111111111111111
        100000000110000000000001
        1011000001110000000000011
        1001000000000000000000001
111111111011000001110000000000001
100000000011000001110111111111111
11110111111111011100000010001
11110111111111011101010010001
11000000000001011100000010001
10000000000000001100000010001
1000000000000001101010010001
110N000111010101111101111000111
11110111 1110101 101111010001
11111111 1111111 111111111111