SO textures/no_img.xpm
WE textures/no_img.xpm
EA textures/no_img.xpm
NO textures/no_img.xpm
F 220,100,255
C 225,30,250

111111
100101
101001
1100N1
111111