SO textures/no_img.xpm
WE textures/no_img.xpm
EA textures/no_img.xpm
NO textures/no_img.xpm
F 220,100,255
C 225,30,001

111111111
101111101
111000111
1110001111111111 1
10N01011
10001101
11111111
111
