SO textures/eagle.xpm
WE textures/eagle.xpm
EA textures/eagle.xpm
NO textures/eagle.xpm
F 220,100,255
C 225,30,250


1111111111111111
1000000000000001
1000000000000001
1000000000000001
1000000000000001
1000000000000001
1000000000000001
1000000000000001
1000000000000001
1000000000000001
1000000000000001
1000000000000001
1000000000000001
1000000000000001
10000000000000N1
1111111111111111