SO textures/eagle.xpm
WE textures/eagle.xpm
EA textures/eagle.xpm
NO textures/eagle.xpm
F 220,100,255
C 225,30,250


1111
10N1
1111