SO textures/no_img.xpm
WE textures/no_img.xpm
EA textures/no_img.xpm
NO textures/no_img.xpm
F 220,100,255
C 225,30,250


1111111111111111
1000000000000001
1000000000000001
1000000000000001
1000000000000001
1000000000000001
1000000000000001
1000000000000001
1000000000000001
1000000000000001
1000000000000001
1000000000000001
100000000N000001
1000000000000001
1000000000000001
1111111111111111